                                                                                
################################################################################
#                             ?     !        !     !     !     !      !    ++++#
#     ########                        ?                    #####              ?#
#     #    +#!                                             ?    #              #
#     #  K +##            #####                                  #             #
#     #     O                   ###       !     #####                          #
#     #######               ?                         ?                        #
#                                 #######################                      #
#                                 #++       K    OO     #      ###       #######
#                 #  ##           #              O     !#                #     #
#     !           #  +#          ################OO!#####    ?                 #
#   #######       # ?+#          ++#                       #####            K! #
#   #     #       #   #   ?   ######                   ?                 #     #
#   #  ?  #####   #   #       #  !#######++                              #######
#   #         #    #   ########     #######                                    #
#   #######   #    #       ?           ?   #######             #####           #
#       !     #    #   #####   #   ######        ############### K !#          #
#   # OO#     #    #          ?#        #        O          ?      #           #
#   #   #     #    ########### ##########################   ########           #
#   # K #     #+                                                          ?    #
#   #####     #+        #####           #####           #####                  #
#     !       ##                                                               #
# ?                           ?     !        !     !     !      !     !    ++++#
################################################################################