WWWWWWWWWWWWWWWW   WWWWWWWWWWWW   WWWWWWWWWWWW  WWWWWWWWWWWW  WWWWWWWWWWWWWWWW W
W ?      SS                 W           W            W                         W
W                           W           W            W                         W
W                           W           W            W                         W
W                           W           W            W                         W
W                           W           W            W                         W
W                           W           W            W                         W
W                                       W            W                         W
W                                       W            W                 %       W
W                           W           W            W                         W
W                           W           W            W                         W
W SS                        W           W            W                         W
W                           W           W      WWWWWWWWWWWWWWWWWWWWWWWWWW??????W
W                           W           W                                      W
W                           W           W                                      W
W                           W           W                                      W
W                           W                                                  W
W                           W                                                  W
W                           W                                                  W
W                           W           W                                      W
W                           W           W                                      W
W                           W           W                                      W
W                           W           W                                      W
W    SSSSSS                 W           W                                      W
WWWWWWWWWWWWWWWW   WWWWWWWWWWWW   WWWWWWWWWWWW  WWWWWWWWWWWW  WWWWWWWWWWWWWWWW W
