WWWWWWWWWWWWWWWW   WWWWWWWWWWWW   WWWWWWWWWWWW  WWWWWWWWWWWW  WWWWWWWWWWWWWWWW W
W                           W           W            W                         W
W                           W           W            W                         W
W                           W           W            W                         W
W                           W           W            W                         W
W                           W           W            W                         W
W                           W           W            W                         W
W                                       W            W                         W
W                                       W            W                 %       W
W                           W           W            W                         W
W                           W           W            W                         W
W                           W           W            W                         W
W                           W           W      WWWWWWWWWWWWWWWWWWWWWWWWWW      W
W                           W           W                                      W
W                           W           W                                      W
W                           W           W                                      W
W                           W                                                  W
W                           W                                                  W
W                           W                                                  W
W                           W           W                                      W
W                           W           W                                      W
W                           W           W                                      W
W                           W           W                                      W
W                           W           W                                      W
WWWWWWWWWWWWWWWW   WWWWWWWWWWWW   WWWWWWWWWWWW  WWWWWWWWWWWW  WWWWWWWWWWWWWWWW W
