                                                                                                         
################################################################################
#                                                                              #
#      #######                ?                    +++++                       #
#      #     #                                     ?      +                    #
#      #  K  #####          +++++                                     ###      #
#      #        #                 +++             #####                 #      #
#      ##   ### #            ?                +          ?              #      #
#                #######################                              ###      #
#                #     ?   K           #            +++                #       #
#                #   +++++++++++++++   #                                ?      #
#                #################   ###      ?                          ?     #
#                              +++++         ?                +++++            D
#                ?         #####                            ?                  #
#                #         #   #                +++++                          #
#          +++++ #   ?     #   #######                                         #
#          #  T  #         #       ?   #######                                 #
#          #  +++++        #   +++++         #                                 #
#          #        ?      #        +   +    #              ?                  #
#          ##########      ###################              +++++              #
#                                                                              #
#      +++++             +++++           +++++                  ?              #
#                                                                              #
#                ?                                                       ?     #
################################################################################
